F1=1000000000000000
F2=0100000000000000
F3=0010000000000000
F4=0001000000000000
A1=0000000000000010
A2=0000000000000100
A3=0000000000000001
A4=0000000000001000
S1=0000100000000000
S2=0000001000000000
S3=0000010000000000
S4=0000000100000000
select=0000000010000000
start=0000000001000000
C1=0000000000100000
C2=0000000000010000
